node  ,bombspot,CT ,T
"CT"  ,"0"     ,"1","0"
"CTA" ,"0"     ,"0","0"
"RCTA","0"     ,"0","0"
"LCTA","0"     ,"0","0"
"A"   ,"1"     ,"0","0"
"LTA" ,"0"     ,"0","0"
"RTA" ,"0"     ,"0","0"
"TA"  ,"0"     ,"0","0"
"T"   ,"0"     ,"0","1"
